$tileset LEVELS/crap.til

$leveldim 18 11

$tilemap

FFFFFFFFFFFFFFFFFF
FFFFFFFFFFFFFFFFFF
FFFFPFPPPPPFPPPPPF
FFFFPFPFFFFFPFFFFF
FFFFPFPFFFFFPFFFFF
FFFFPFPPPPPFPPPPPF
FFFFPFPFFFFFPFFFFF
FPFFPFPFFFFFPFFFFF
FFPPFFPPPPPFPPPPPF
FFFFFFFFFFFFFFFFFF
FFFFFFFFFFFFFFFFFF

$player ACTORS/DUDE1.ACT 190.0 80.0 0.0